AllScripts=All scripts
ClassName=Class name
CodeRunning=Code is running...
DebugCancel=Cancel
DebugContinue=Continue
DebugStepOver=Step over
DebugStop=Stop debugging
Dependencies=Dependencies
DependenciesCaption=%1 dependencies
DownloadAsXml=Download
Editor=Editor
EditScript=Edit script
Execute=Execute
ExecutionCompleted=X++ code execution completed in %1.
ExecutionCompletedError=X++ code execution completed with errors.
ExecutionCompleteWait=Wait until the current execution is completed.
ExecutionLog=Script execution log
ExecutionLogClean=Clean
ExecutionLogCleanConfirm=All execution log will be cleared. Are you sure you want to continue?
ExecutionLogCleanOperation=Clean operation executed
ExecutionLogHelp=Display script execution log
ExecutionParameters=Execution parameters
ExecutionPaused=Execution is paused...
ExecutionRoleException=For Tier 2 and above environments, only members of MXT Script executor role can execute scripts
ExportAsJson=Export as MXT
ExportRunnableClass=Export runnable
GlobalTtsAbort=Emit global ttsAbort
GlobalTtsAbortHelpText=Wraps the execution into a global transaction that will be aborted at the end.
ImportMXT=Import MXT
Interpreter=Interpreter
InvalidPropertyError=Invalid property name %1
Language=Language
Links=Links
LoadFromFile=Load from file
MaxLoopIterations=Loop iteration limit
MXTWorkspace=MXT X++ Interpreter
NewLabel0=Label files created on 04/04/2024 16:18:17 for label file Id MXT and language en-US
 ;Label file comment - see above label
NewScript=New script
NewScriptCaption=New script*
NothingToExecute=There is nothing to execute...
OpenForExecution=Open for execution
OpenGithubRepository=Github repository
OpenInEditor=Open in Editor
Operations=Operations
Schedule=Schedule
Script=Script
ScriptId=Script ID
Scripts=Scripts
SkipLog=Skip execution log
SourceCode=Source code
SysAdminExecutionException=Only members of System Administrator role can execute scripts
TSql=T-Sql
VariableInspectorName=Name
VariableInspectorType=Type
VariableInspectorValue=Value
Xpp=X++
XppCodeInterpreter=X++ Code Interpreter Editor
XppCodeRunner=X++ Code Runner
XppInterpreterExecutorRole=MXT Script executor
XppInterpreterExecutorRoleHelp=Users in this role can run MXT X++ Interpreter scripts
XppInterpreterParameters=X++ Interpreter parameters
XppInterpreterParametersSimple=Configuration
